1111111111111111111111111111111111
1E000000PC000000000000000000000001
1111111111111111111111111111111111