111111111111111
10000EP0C000001
111111011111111
100000000000001
111111111111111