1111111111111
1E00000000001
1C00011111001
1P00001000001
1111111111111