111111111111111
1001C0000E0P001
111111111111111
100000000000001
111111111111111