111111111111111
10010000CE0P001
111111111111111
100000000000001
111111111111111